htn elev. chol. right facial droop with treatment secondary to problem to face right nephrectomy	TrAP
discharge instructions : may shower , no bathing or swimming for 1 month no creams , lotions or treatment to problem no driving for 1 month no lifting > 10 # for 10 weeks	TrNAP
test prior to scheduled cath showed problem , inferior hk , ef 40% , mild mr , mild lae .	TeRP
test prior to scheduled cath showed mild lvh , problem , ef 40% , mild mr , mild lae .	TeRP
Transferred in urgently for cabg with Dr. Howard .	None
PT - 13.6* PTT - 33.3 INR ( PT ) - 1.2*	None
There has been removal of a Swan-Ganz catheter and placement of a right internal jugular vascular catheter , with the tip terminating in the proximal right atrium just below the junction with the superior vena cava .	None
Previously reported interstitial edema has resolved .	None
There has been interval improvement in left basilar atelectasis .	None
Bilateral pleural effusions are unchanged .	None
There is mild symmetric left ventricular hypertrophy .	None
Overall left ventricular systolic function is mildly depressed .	None
Resting regional wall motion abnormalities include mild inferior hypokinesis .	None
There are three aortic valve leaflets .	None
No masses or vegetations are seen on the aortic valve .	None
Trace aortic regurgitation is seen .	None
Trivial mitral regurgitation is seen .	None
There is no pericardial effusion .	None
test showed sinus brady , with problem .	TeRP
bilateral crackles at bases and midlungs , elevated jvp , trace bilateral ankle edema , and cxr with diffuse opacities suggest possible problem2 , likely secondary to problem1 .	PIP
bilateral crackles at bases and midlungs , elevated jvp , trace bilateral ankle edema , and test with problem suggest possible pulmonary edema , likely secondary to acute mi .	TeRP
test , problem .	TeRP
Jacob U. Rolland , M.D.	None
EKG showed sinus brady , with old LAD and new ST depressions in V1-V4 .	None
WBC - 11.4* RBC - 3.61* Hgb - 11.4* Hct - 32.6* MCV - 90 MCH - 31.7	None
There is no pneumothorax .	None
MCHC - 35.3* RDW - 14.8 Plt Ct - 214	None
We decided given her age that she would not be a good candidate for cardioversion for her afib nor would she be a good candidate for coumadin .	None
Therefore we will continue rate control with metoprolol this can be titrated if needed , and aspirin and plavix for anti-coagulation .	None
before this age , the family and other caregivers should be considered for treatment against problem to protect the infant .	TrAP
he was noted to have problem and for this was started on treatment .	TrAP
test revealed s1 and s2 regular , no problem , 2+ femoral pulses .	TeRP
Neck was supple without masses or defects .	None
With the initiation of caffeine therapy the patient has had no more apnea or bradycardic events .	None
The patient was initially started on nasal prong CPAP at 6 and required additional oxygen to 35% .	None
The morning of transfer his IV came out so he has just been advanced to 120 cc per kg per day of PE-20 and his tolerating these PG feedings without difficulty .	None
His most recent bilirubin was 6.6 on day of life six , the day of discharge , and his phototherapy was discontinued. He will need a rebound bilirubin level in am .	None
He is due to have his state screen sent today .	None
2. problem ( on treatment ) .	TrAP
abd : soft , problem1 with problem2 , no hsm , hyperactive bs	PIP
proceed to the er/ew/monica if problem1 becomes red , problem2 , warm , or produces pus .	PIP
go to an emergency room if you experience problem1 including , but not necessarily limited to : new and continuing nausea , vomiting , fevers ( >101.5 f ) , chills , or problem2 .	PIP
Abd : soft , +distension with tympany , no HSM , hyperactive BS	None
NSR at 62 , nl axis , nl intervals , Q waves in III , avR , V1 .	None
TWI 's in III , V1 .	None
GLUCOSE - 94 UREA N - 22* CREAT - 1.4* SODIUM - 142	None
On HD2 , cardiac clearance was obtained by Dr. Sanchez .	None
ICU for 24hr post-op cardiac monitoring .	None
On POD1 , patient was transferred out of FICU to 12R .	None
2. Atorvastatin Calcium 20 mg Tablet Sig : One ( 1 ) Tablet PO DAILY ( Daily ) .	None
DR. Freddy Darr on :	None
test sent to pathology revealing problem .	TeRP
He presented on 2016-11-21 for resection .	None
He was admitted on 2016-11-21 following his surgery .	None
Includes hypertension and chronic obstructive pulmonary disease .	None
Triamterene/hydrochlorothiazide 37.5/25 mg one tablet by mouth once daily and lorazepam 1 mg three times daily as needed ( for anxiety ) .	None
Frozen section sent to pathology revealing invasive squamous cell carcinoma .	None
The patient was admitted to the Surgical Intensive Care Unit postoperatively .	None
G-tube was to gravity , Foley to gravity , left radial A-line .	None
The flap was pink with a strong Doppler signal .	None
Postoperative laboratories revealed sodium was 134 , potassium was 4.1 , chloride was 102 , bicarbonate was 28 , blood urea nitrogen was 18 , creatinine was 0.8 , and glucose was 148 .	None
Right arm neurovascularly intact .	None
He was weaned from ventilation on postoperative day one to pressure support ventilation and then to spontaneous breathing on postoperative day two .	None
The cuff on his tracheostomy tube was put down on 11-23 , postoperative day two which he tolerated well with minimal secretions and a strong adequate cough .	None
His tube feedings were advanced .	None
there was problem2 and problem1 .	PIP
1. treatment 100 mg po t.i.d. for problem .	TrAP
test revealed a regular rate and rhythm with no murmurs , rubs or problem .	TeRP
test remained relatively unchanged , with resolution of problem and right facial weakness .	TeRP
test remained relatively unchanged , with resolution of the subtle left hand weakness and problem .	TeRP
test and rapid alternating movements were problem and she had trouble isolating individual finger movements .	TeRP
she was seen again by primary care physician , roderick since she had complaints of problem2 , as well as a new complaint of decreased hearing and the sensation of static in her ears , problem1 was considered .	PIP
there was no problem2 of problem1 .	PIP
Mrs. Wisniewski is a 45-year-old woman with multiple familial cavernous hemangiomas .	None
She developed an ear ache , for which she saw her primary care physician , Evelyn was prescribed cortisone drops .	None
She was seen again by primary care physician , Roderick since she had complaints of dizziness , as well as a new complaint of decreased hearing and the sensation of static in her ears , meniere 's disease was considered .	None
She no longer observes that belief system .	None
Cardiovascular exam revealed a regular rate and rhythm with no murmurs , rubs or gallops .	None
She was able to give a detailed history in an organized manner .	None
There was no evidence of any special neglect .	None
Extraocular movements were full with normal smooth pursuit to the left .	None
Hearing was diminished for conversational speech .	None
Reflexes were brisk in the legs with 4-5 beats of clonus at the ankles bilaterally .	None
There was some mild surrounding edema .	None
There was a larger area of susceptibility artifact in the left temporal lobe , right frontal lobe , and the splenius of the corpus collasum .	None
on test , he is problem .	TeRP
his past medical history is significant for prostate cancer , benign prostatic hypertrophy , hypothyroidism , status post treatment for problem , chronic painless hematuria , degenerative joint disease and history of a murmur .	TrAP
he was initially admitted to cmed for treatment and repair of problem .	TrAP
he was initially admitted to cmed for resection and treatment of problem .	TrAP
This is an 85 year old man initially admitted to the Plastic Surgery Service for evaluation of a left facial mass .	None
Regular rate and rhythm .	None
He is being discharged to rehabilitation to follow up for XRT given the fact that his pathology revealed squamous cell cancer extending deep to the margin as well as positive level II nodes .	None
He should also follow up with Dr. Rankin and Dr. Langhorne .	None
Signed electronically by : DR. Jermaine X Reynolds on : Andrea 2016-06-30 3:46 PM	None
( End of Report )	None
during er evaluation pt was noted to have some degree of dyspnea as well as problem1 , including problem2 and brief unresponsive period after one dose of iv benadry and steroids prior to ct scan .	PIP
during er evaluation pt was noted to have some degree of dyspnea as well as problem1 , including loss of short term memory and problem2 after one dose of iv benadry and steroids prior to ct scan .	PIP
In ER c/o dyspnea and was noted to have mental status changes .	None
Major Surgical or Invasive Procedure : none this admission	None
AVR ( tissue ) 05-14	None
Postop course c/b right upper extremity DVT and postop Afib .	None
Discharged home 05-19 with instructions to f/u in vascular clinic .	None
At that time had UE duplex which revealed RUE DVT involving IJ , Axillary , subclav , brachial , and basilic veins .	None
Social History : lives with partner	None
Ext : + distal pulses , no edema	None
CV:RRR S1-S2 , no MRG	None
Abdm : soft , NT/ND/NABS	None
BLOOD WBC - 12.9 * RBC - 3.37 * Hgb - 10.4 * Hct - 29.4 * MCV - 87 MCH - 30.8 MCHC - 35.3 * RDW - 13.3 Plt Ct - 345	None
BLOOD HEPARIN DEPENDENT ANTIBODIES - positive	None
Over the next several days the patient was maintained on Argatrobanwhile coumadin therapy was initiated .	None
1. crohn 's disease , dx 1974 s/p treatment and eventual ileostomy , resulting in problem	TrCP
pt initially with mild ari , this was thought to be due to problem , after treatment her renal function improved to her baseline .	TrAP
as the cxr was without any evidence of pna , or ptx , the pt subsequently received test to evaluate for problem which revealed multifocal bilateral pna but no problem .	TeCP
6. problem s/p treatment in 80 's	TrAP
these findings are consistent with problem2 with problem1	PIP
5. problem s/p " pin placement " in left foot 05-01	TrAP
given her hx of treatment secondary to problem and resultant short gut syndrome , the pt requires nutritional support via tpn .	TrAP
9. port-a-cath placement for treatment in setting of problem , complicated by clotting x 4 , requiring replacement	TrAP
problem improved on treatment over the next few days and she was weaned off treatment on 2013-01-01 .	TrIP
absomen soft , problem to test , but no guarding or rebound	TeRP
54 yo f with problem s/p treatment and subsequent short gut syndrome with port-a-cath placement for tpn who presents with progressive right sided chest pain that comes in waves .	TrAP
given her hx of ileostomy secondary to crohn 's disease and resultant problem , the pt requires nutritional support via treatment .	TrAP
54 yo F with Crohn 's s/p ileostomy and subsequent short gut syndrome with port-a-cath placement for TPN who presents with progressive right sided chest pain that comes in waves .	None
It is associated with SOB as well as fevers , chills .	None
She was also given morphine 2 mg x3 , 4 mg IV x2 , dolasetron 12.5 mg x2 and ativan 1 mg IV x1 .	None
Gen : middle aged obese female lying in bed on her left side asleep , speaking slowly .	None
Abd : obese , multiple surgical scars .	None
absomen soft , tender to palpation over RUQ , but no guarding or rebound	None
CK ( CPK )- 31	None
This is consistent with the remainder of the pt 's history including fever , chills , sob and an elevated WBC count .	None
The pt was given ceftriaxone / azithromycin / vancomycin in Deanna .	None
no treatment , lotions , powders , or ointments to problem	TrNAP
no creams , treatment , powders , or ointments to problem	TrNAP
no creams , lotions , powders , or treatment to problem	TrNAP
test revealed problem .	TeRP
test 10-30 : problem has partially cleared .	TeRP
monitor problem1 for problem2 - redness , drainage , or increased pain	PIP
Patient recorded as having No Known Allergies to Drugs	None
Coronary Artery Bypass Graft x3 ( Left internal mammary -> left anterior descending , saphaneous vein graft -> obtuse marginal , saphaneous vein graft -> posterior descending artery ) 2018-10-25	None
Cath revealed severe 3 vessel disease .	None
Then referred for surgical intervention .	None
Father with MI in 50 's and underwent CABG .	None
VS : 65 20 160/100 5 ' 7 " 180 #	None
Echo 10-25 : PRE-BYPASS : Left ventricular wall thicknesses are normal .	None
There is no aortic valve stenosis .	None
2018-10-31 06:25 AM BLOOD WBC - 13.6 * RBC - 2.72 * Hgb - 8.6 * Hct - 24.6 * MCV - 91 MCH - 31.7 MCHC - 35.0 RDW - 14.0 Plt Ct - 314	None
2018-10-25 11:15 AM BLOOD PT - 13.3 * PTT - 30.0 INR(PT) - 1.2 *	None
2018-10-25 12:36 PM BLOOD UreaN - 17 Creat - 0.7 Cl - 111 * HCO3 - 23	None
2018-10-31 06:25 AM BLOOD Glucose - 91 UreaN - 19 Creat - 0.8 Na - 134 K - 4.0 Cl - 98 HCO3 - 26 AnGap - 14	None
Please see operative report for surgical details .	None
He did have burst of atrial fibrillation and was started on a Amiodarone gtt .	None
the patient had problem on test .	TeRP
she presented with three days of general malaise , nausea , vomiting , shortness of breath , problem1 productive of problem2 .	PIP
there was some question regarding restarting of treatment given problem as well as the presence of her basilar artery stenosis .	TrNAP
for problem , continued on treatment 10 mg daily .	TrAP
this is an 83 year old woman with a history of hypertension who presents with problem1 when problem2 .	PIP
the patient also had test in the emergency department before coming to the unit which reported no recent bleed and no problem from a prior ct scan done on 2011-03-04 .	TeRP
on test she was a well developed , well nourished female in no problem .	TeRP
Abdomen is soft and obese , nontender .	None
For her paraplegia and associated muscle spasticity she was continued on her Zanaflex .	None
She was also evaluated by Physical Therapy and Speech and Swallow because of some report of dysphagia .	None
9. Trazodone 25 mg q. h.s. p.r.n.	None
11. Zanaflex 2 mg twice a day .	None
1. She was instructed to have blood drawn by the Visiting Nurses Association the day after discharge and then a few days after discharge the same week to have INR .	None
this is a 47 - year-old male with a past medical history of type 2 diabetes , high cholesterol , hypertension , and coronary artery disease , status post percutaneous transluminal coronary angioplasty times two , who presented with problem refractory to treatment and tnk , now status post angio-jet percutaneous transluminal coronary angioplasty and stent of proximal left anterior descending artery and percutaneous transluminal coronary angioplasty of first diagonal with intra-aortic balloon pump placement .	TrWP
in the emergency department he received aspirin , nitroglycerin drip , heparin drip , dilaudid , and treatment with decreased in problem but without resolution of symptoms .	TrIP
the patient is a 47 - year-old male with a past medical history of problem , status post 2-vessel percutaneous transluminal coronary angioplasty in 2005 , treatment in 2009 , hypertension , new onset type 2 diabetes , and hypercholesterolemia who presents with the sudden onset of substernal chest pain status post exercise .	TrAP
1. problem ; the patient is treatment times three in 2009 at clinton hospital ; the patient is treatment times two in 2005 at waltham/weston hospital .	TrAP
in the emergency department he received aspirin , treatment , heparin drip , dilaudid , and tnk with decreased in problem but without resolution of symptoms .	TrIP
this is a 47 - year-old male with a past medical history of type 2 diabetes , high cholesterol , hypertension , and coronary artery disease , status post percutaneous transluminal coronary angioplasty times two , who presented with problem refractory to medical treatment and tnk , now status post angio-jet percutaneous transluminal coronary angioplasty and treatment and percutaneous transluminal coronary angioplasty of first diagonal with intra-aortic balloon pump placement .	TrAP
test showed an ejection fraction of 30% , moderate systolic dysfunction , problem , mid anterior akinesis , basal anteroseptal hypokinesis , mid anteroseptal akinesis .	TeRP
problem included treatment and iodine .	TrCP
Of note , he had a negative stress test in 2012-07-03 .	None
No tobacco at this time ; he quit 20 years ago .	None
The patient is married .	None
Temperature maximum 98.7 , temperature current 98.3 , pulse ranged from 82 to 92 , blood pressure 104 to 124/67 to 74 with a mean of 86 to 99 , respiratory rate of 11 to 16 , oxygen saturation 94% to 98% on 2 liters .	None
Intra-aortic balloon pump augmented systole was 109 , augmented diastole was 111 .	None
Cardiovascular revealed jugular venous distention not appreciated .	None
Abdomen had decreased bowel sounds , soft , nontender , and nondistended .	None
Cranial nerves II through XII were intact .	None
Arterial blood gas at 11 a.m. was 7.33/46/115 .	None
Anterior apex akinesis , inferior apex akinesis , and apex akinesis .	None
The was trace mitral regurgitation and trace tricuspid regurgitation .	None
9. oxycodone - treatment 5-325 mg tablet sig : 1-2 tablets po q4-6h ( every 4 to 6 hours ) as needed for problem .	TrAP
a swan was placed for a more accurate picture of his volume status and he was problem by test with an elevated pad and elevated cvp without an obtainable wedge pressure .	TeRP
test showed problem in a paced rhythm .	TeRP
for problem , they recommended gentle cleansing with normal saline or treatment , thin layer of duoderm gel , air dry , allevyn foam adhesive over the site , and change every 2 days or prn .	TrAP
for problem , they recommended gentle cleansing with normal saline or commercial wound cleaner , thin layer of treatment , air dry , allevyn foam adhesive over the site , and change every 2 days or prn .	TrAP
test showed improvement of problem and on discharge he had been breathing well on room air without complications	TeRP
problem1 with bilateral effusions ( r > l ) , with possible problem2 and to a lesser degree the rml and lll .	PIP
this acutely worsened on 2017-09-18 , when the patient was found to have mental status changes and an abg revealed a co2 of over 100 , likley due to a depressed respiratory drive secondary to treatment given for problem on top of a preexisting alkalosis .	TrAP
this acutely worsened on 2017-09-18 , when the patient was found to have mental status changes and an abg revealed a co2 of over 100 , likley due to problem1 secondary to sedatives given for agitation on top of problem2 .	PIP
neurology was also consulted and test showed problem but no acute causes for a change in mental status .	TeRP
the patient has a history of baseline dementia which was confounded by problem2 in the face of problem1 .	PIP
70 y/o male with h/o CAD s/p LAD PTCA 33 yrs ago , COPD , T2DM , and AICD pocket infection who presented to the Juan on 2017-09-03 with worsening SOB x 5 days and feeling " cloudy ."	None
He was given Percocet for back pain , Lasix 80 mg IV , and Combivent neb .	None
He was quickly weaned to 3L O2 via NC , O2 sats 100% .	None
Prior to that smoked 2 packs a day .	None
No other known family hx .	None
2017-09-03 PLT COUNT - 124 *	None
Right-sided PICC line with its tip in the distal SVC .	None
1. problem treatment and chemotherapy in french guiana , s/p right pneumonectomy in 2016-09-21 for recurrence .	TrAP
1. problem s/p xrt and treatment in french guiana , s/p right pneumonectomy in 2016-09-21 for recurrence .	TrAP
development of small loculated pleural fluid collection along the periphery of the left major fissure or problem , consistent with test .	TeRP
problem1 indicates problem2 .	PIP
at osh , test grew pseudomonas and problem , and he was restarted on zosyn ( 08-08 ) and vancomycin ( 08-09 ).	TeRP
test demonstrated problem , likely cardioembolic .	TeRP
10. recent mrsa pneumonia and problem 2017-07-21 , treated with treatment	TrAP
2017-08-15 test - preliminary { problem }	TeRP
13. treatment 2017-07-21 02-22 problem	TrAP
Transfer from Athol Memorial Hospital for acute on chronic respiratory distress .	None
At OSH , sputum cultures grew Pseudomonas and MRSA , and he was restarted on Zosyn ( 08-08 ) and Vancomycin ( 08-09 ).	None
Suctioned X 1 , mucus not cleared .	None
In John , BP 80/60 , HR 80 .	None
Stool sent for C.diff and given Flagyl 500 mg PO X 1 dose .	None
1. Non-small cell lung cancer s/p XRT and chemotherapy in French Guiana , s/p right pneumonectomy in 2016-09-21 for recurrence .	None
2. SSS status post PM/ICD placement	None
5. CAD , with known TO RCA .	None
14. Status post partial colectomy 1972	None
Son is next of kin .	None
Ronchorous breath sounds left chest .	None
Good pedal pulses peripherally .	None
Withdraws to painful stimulus .	None
Moves all 4 extremities .	None
WBC - 4.9 RBC - 2.92 * HGB - 8.8 * HCT - 26.2 * MCV - 90 MCH - 30.1 MCHC - 33.5 RDW - 18.5 * NEUTS - 86.5 * LYMPHS - 7.5 * MONOS - 4.7 EOS - 1.2 BASOS - 0.1 PLT COUNT - 145 * GLUCOSE - 91 UREA N - 21 * CREAT - 0.6 SODIUM - 143 POTASSIUM - 4.2 CHLORIDE - 106 TOTAL CO2 - 32 ANION GAP - 9 LACTATE - 1.4 K+ - 3.9	None
Afib , occasional V-paced , rate 83 bpm .	None
Long QT interval ( QTc 462 ms ).	None
6. problem on treatment - pt has problem secondary to her dm and is on treatment .	TrAP
5. problem - patient was initially covered with treatment while septic and then transitioned back to insulin sliding scale .	TrAP
she was also started on treatment for problem , to be treated with treatment for total 7 days .	TrAP
pt was due for treatment but missed it secondary to problem .	TrNAP
6. problem1 on hd - pt has problem1 secondary to problem2 and is on hd .	PIP
6. problem on treatment - pt has problem secondary to her dm and is on treatment .	TrAP
she was found to be problem to 101.9 and received levoflox and treatment .	TrAP
pt was recently admitted to the hospital for orthopedics from 12-07 thorugh 12-14 with problem1 thought to be secondary to problem2 at hd.	PIP
test without problem .	TeRP
although there was never problem isolated from test you had some bacteria in the urine which you are being treated for .	TeRP
Then , this morning she developed fatigue and did not eat well .	None
She was found to be febrile to 101.9 and received levoflox and vancomycin .	None
Post-intubation , the pt 's BP acutely dropped to 58/19 in the setting of propofol .	None
Per pt 's son , she is bedbound at baseline due to her multiple LE femur fractures .	None
Pt was due for HD but missed it secondary to her illness .	None
GLUCOSE - 210 * UREA N - 29 * CREAT - 3.2 * SODIUM - 139 POTASSIUM - 3.9 CHLORIDE - 112 * TOTAL CO2 - 17 * ANION GAP - 14	None
WBC - 9.0 RBC - 2.93 * HGB - 9.0 * HCT - 29.7 * MCV - 101 * MCH - 30.8 MCHC - 30.4 * RDW - 24.1 *	None
MICRO : sputum 12-27 : grm stn and cx negative	None
6. problem - the patient has a history of problem , ever since treatment for his prostate cancer .	TrCP
in addition the patient was started on treatment since his heart rate had remained problem in the low 100s .	TrAP
it was felt that this potentially had lead to his atrial flutter and problem2 with problem1 .	PIP
test did not reveal any evidence of problem or of any obstructing pancreatic mass .	TeRP
test did not reveal any evidence of biliary dilatation or of problem .	TeRP
again seen was problem1 with problem2 suggesting chronic hepatic vascular congestion .	PIP
1. hypotension - the patient was initially problem with test in the 80s .	TeRP
test showed moderate dilated left atrium , no atrioseptal defect , severe global left ventricular hypokinesis with problem and moderately dilated right ventricle .	TeRP
test showed moderate dilated left atrium , no atrioseptal defect , severe global left ventricular hypokinesis with severe left ventricular systolic function and problem .	TeRP
test showed atrial fibrillation with problem and atrial flutter .	TeRP
electrocardiogram showed problem1 with problem2 and atrial flutter .	PIP
4. test - the patient had an isolated , elevated alkaline phosphatase with problem in his gamma glutamyl transferase .	TeRP
test did not reveal any cholelithiasis or problem , however , an irregular hepatic contour was seen which is suggestive of underlying chronic liver disease .	TeRP
test did not reveal any cholelithiasis or cholecystitis , however , problem was seen which is suggestive of underlying chronic liver disease .	TeRP
ace inhibitors , possible problem to treatment reported by the patient during a treatment swallow 25 years ago .	TrCP
however , subsequent it was determined that problem1 may have been related to his rapid ventricular response and problem2 .	PIP
in addition the patient was started on verapamil since test had remained problem in the low 100s .	TeRP
He is a retired fire fighter .	None
Serial cardiac enzymes negative .	None
Therefore the focus of treatment was changed to controlling his rate .	None
The remainder of the hospital course will be dictated by the covering intern .	None
Dictated By : Marjorie I. Taylor , M.D.	None
During the last four hospital days , the continued to do relatively well .	None
Her renal function significantly improved , and her discharge creatinine was 3.1 .	None
1. Coronary artery disease .	None
2. Congestive heart failure .	None
1. Amiodarone 200 mg p.o. q day .	None
2. Warfarin 3 mg p.o. q h.s.	None
14. Regular insulin sliding scale .	None
she eventually underwent test to assess coronary disease which revealed problem .	TeRP
no creams , treatment or ointments to problem .	TrNAP
problem1 of the origin of the right vertebral artery may be problem2 in nature .	PIP
Coronary Artery Disease , Hypertension , Hyperlipidemia , Diabetes Mellitus , Hypothyroid , h/o Bilateral DVT 's ( on chronic coumadin therapy ), Pleural disorder ? Sarcoidosis , Gastritis , B12 deficiency , Chronic renal insufficiency , s/p Appendectomy , s/p Lap cholectomy , s/p Total abdominal hysterectomy	None
Denies tobacco or ETOH use .	None
The mediastinum appears unchanged .	None
2015-11-12 06:00 AM BLOOD WBC - 7.7 RBC - 2.73 * Hgb - 8.3 * Hct - 25.1 * MCV - 92 MCH - 30.4 MCHC - 33.1 RDW - 15.5 Plt Ct - 528 *	None
2015-11-12 06:00 AM BLOOD Glucose - 85 UreaN - 19 Creat - 1.6 * Na - 140 K - 4.4 Cl - 105 HCO3 - 24 AnGap - 15	None
She tolerated the procedure well and was transferred to the CSRU for invasive monitoring in stable condition .	None
he was started on p.o. steroids and to cmed for management of copd exacerbation but he appeared in problem overnight and was started on treatment and more frequent nebulizers for copd .	TrAP
He was continued on p.o. prednisone and frequent nebulizers for COPD .	None
Dictated By : Margaret BT Mahaffey , M.D.	None
the patient is a 47 year old male , with problem1 secondary to problem2 diagnosed about 5 years prior to admission .	PIP
problem1 was also healing well by the time of discharge with no evidence of problem2 .	PIP
The patient 's serum creatinine on the day of discharge , on 2013-05-06 , was 1.9 , but was noted to increase to	None
The patient was admitted with concern for hepatorenal syndrome .	None
1. Miconazole nitrate powder tid prn for groin rash .	None
3. Lactulose 30 ml tid ( titrated to 4 to 5 bowel movements qd ) .	None
As previously mentioned , the patient 's creatinine at the time of admission was up to 3.6 from 1.9 at the time of his discharge 3 days prior .	None
Optimization of his fluid balance was managed by the medical service in consultation with hepatology and renal .	None
The patient 's INR on admission was 2.4 , with his PT level being 18.9 .	None
The patient 's nutrition was suboptimal , and the patient was started on tube feeding .	None
The patient underwent diagnostic and therapeutic paracentesis on 2013-05-16 , 2013-05-21 , and 2013-05-24 .	None
He was advanced to a regular house diet later on postop day 3 .	None
The patient 's appetite improved significantly , and at the time of discharge the patient was on a regular diet with no tube feed supplements deemed necessary .	None
The patient was ultimately deemed ready for discharge on postoperative day 8 .	None
HISTORY OF PRESENT ILLNESS :	None
She takes 14 units of NPH insulin twice a day supplementing with a sliding scale .	None
Her chest and cardiovascular examinations are unremarkable .	None
She underwent cadaveric pancreas transplantation without complication .	None
Signed electronically by : DR. Jacob Butler on : WED 2016-11-16 7:45 AM	None
patient was started on heparin drip and test were done which were negative for problem .	TeRP
probable problem1 , consistent with problem2	PIP
Attending : Louie A. Keith , M.D.	None
Major Surgical or Invasive Procedure :	None
Patient has a history of suicidal ideations and self mutilation .	None
Per OMR , h/o sporadic marijuana use .	None
She has completed up to the tenth grade of high school .	None
RR nl S1 S2 no m	None
WBC - 9.4 # RBC - 4.75 HGB - 14.7 HCT - 42.2 MCV - 89 MCH - 30.9 MCHC - 34.8 RDW - 13.6	None
Dermatology and plastic surgery were consulted who felt that symptoms were due to trauma ; it was not felt that patient had compartment syndrome .	None
Patient was splinted and UE were kept elevated .	None
Patient was gradually put back on her outpatient xanax dose of 1 mg qid and clozaril was restarted .	None
Patient was transferred to floor after spending 1 day in the ICU .	None
test was significant for progressive abdominal discomfort , problem , and weakness in the past nine weeks .	TeRP
test revealed no clubbing , cyanosis , or problem .	TeRP
he also complained of problem2 and " problem1 ."	PIP
test was done which disclosed possible problem as well as infiltrates consistent with aspiration pneumonia .	TeRP
the patient was bolused with treatment due to concern for problem .	TrAP
due to problem , an nasogastric tube was placed for treatment .	TrAP
HISTORY OF PRESENT ILLNESS :	None
1. Benign prostatic hypertrophy .	None
3. Gastrointestinal adenocarcinoma ( as noted in History of Present Illness ) .	None
Colace , Senna , Dulcolax , Tylenol , oxycodone as needed , Ambien , and Protonix .	None
Father had coronary artery disease .	None
The patient was employed as a salesman .	None
Cardiovascular examination revealed tachycardic first heart sound and second heart sound .	None
Extremity examination revealed no clubbing , cyanosis , or edema .	None
The patient was bolused with intravenous heparin due to concern for pulmonary embolism .	None
On 05-03 the patient underwent an abdominal ultrasound with paracentesis , and 5 liters of fluid were removed .	None
On 05-04 , the patient was transferred back to the O-CMED CSRU	None
he will need to follow up with hematology for an outpatient thrombophilia work-up ( not done as inpatient as results would not change treatment of problem ).	TrAP
given no evidence of problem , treatment was not required .	TrAP
he did have problem1 , felt to be related to problem2 in the setting of p-pulmonale related to clot burden .	PIP
Major Surgical or Invasive Procedure :	None
45M w/no PMH presented to Chelseahospital after a syncopal episode on the morning of admission .	None
Pt was preparing lunch when suddenly felt lightheaded / faint and immediately fell to the kitchen floor face first .	None
Mr. Anders states that 2 weeks prior to his presentation he hurt his left knee .	None
Pt denied any bleeding or clotting disorders and has never had a clot in the past .	None
- Lives w/ wife & son in Jose , MA	None
- Denies TOB use , occasional ETOH use	None
GEN : NAD , pleasant speaking in full sentences	None
No evidence of acute intracranial hemorrhage or fractures .	None
Left ventricular wall thicknesses are normal .	None
Left ventricular systolic function is hyperdynamic ( EF > 75% ) .	None
There is moderate pulmonary artery systolic hypertension .	None
There is no pericardial effusion .	None
2. Moderate knee joint effusion with possible ganglion cyst at the insertion of the PCL .	None
He has no known clotting disorder but did have trauma to leg prompting immobility and stasis .	None
test was remarkable for a questionable problem .	TeRP
the patient has a history of high mcv and problem on test in the setting of anemia ; question b12 deficiency , the patient also has a history of borderline low b12 levels .	TeRP
given the presence of problem on chest x-ray , however , and previous history of pneumonia , the patient was maintained on antibiotics of treatment 500 mg daily and ceftriaxone .	TrAP
given the presence of consolidation on chest x-ray , however , and previous history of problem , the patient was maintained on antibiotics of zithromax 500 mg daily and treatment .	TrAP
the patient has a history of high mcv and problem2 on smear in the setting of problem1 ; question b12 deficiency , the patient also has a history of borderline low b12 levels .	PIP
mucomyst was also considered as treatment towards problem .	TrAP
the patient was maintained on treatment for reflux disease and problem .	TrAP
problem status post negative test on 10-12 .	TeRP
after bipap was initiated , the patient became hypotensive down to 75/28 and problem , responding to treatment over the course of the night .	TrIP
after bipap was initiated , the patient became problem down to 75/28 and bradycardiac , responding to treatment over the course of the night .	TrIP
Chronic inflammatory demyelinating polyradiculopathy .	None
Question of Tyrone esophagus .	None
Anemia of chronic disease .	None
History of 20-to-30-pack-year smoking , quit approximately 15 years ago .	None
She denies any alcohol or drug use .	None
Married with children , wheelchair bound mostly .	None
Diffuse bronchial breath sounds , no wheezes .	None
7. Zanaflex 8 mg q.4 h. 	None
10. Lipitor 10 mg q.p.m.	None
11. Ativan 2 mg p.r.n.	None
12. Protonix 20 mg p.o. b.i.d.	None
14. Albuterol nebulizer q.03-14 h. p.r.n.	None
The patient was maintained on IV Solu - Medrol 60 mg q. 8 h.	None
The patient was maintained on PPI for reflux disease and known gastritis .	None
1. problem , diagnosed in 2018-03-21 , status post treatment at st. margaret's center for women & infants in 03/2006 .	TrAP
patient recorded as having no problem to treatment	TrCP
problem1 with problem2 .	PIP
of note , he was hospitalized at dana-farber cancer institute from 9/25-10/6 with problem , at which time he reportedly had test , an echocardiogram and a pharmacological stress test performed .	TeCP
3) problem : test improved from 2.1 to 1.3 at time of discharge .	TeCP
2) test ( 06-14 ): new bibasilar consolidations are demonstrated accompanied by problem .	TeRP
5. treatment 15 mg tablet sig : one ( 1 ) tablet po q4-6h ( every 4 to 6 hours ) as needed for problem .	TrAP
mr. mcelveen is a 51 year-old male with problem status post left radical nephrectomy in 2018-03-21 , status post treatment and sorafenib , most recently on sutent monotherapy since 2018-12-21 , with mild renal insufficiency , who presented from home on 2019-06-14 with shortness of breath and fever .	TrAP
mr. mcelveen is a 51 year-old male with problem status post left radical nephrectomy in 2018-03-21 , status post avastin and sorafenib , most recently on treatment since 2018-12-21 , with mild renal insufficiency , who presented from home on 2019-06-14 with shortness of breath and fever .	TrAP
together with the interval development of bilateral pleural effusions , this indicates cardiac insufficiency ( or alternatively problem ) and test may be indicated for further evaluation .	TeCP
together with the interval development of problem , this indicates cardiac insufficiency ( or alternatively volume overload ) and test may be indicated for further evaluation .	TeCP
together with the interval development of bilateral pleural effusions , this indicates problem ( or alternatively volume overload ) and test may be indicated for further evaluation .	TeCP
4) test ( 06-18 ): problem with preserved biventricular systolic function .	TeRP
4. problem2 with persistent distal ileal wall thickening and diffuse mesenteric stranding , most likely reflecting problem1 .	PIP
He denies chills , no chest pain , no LE swelling .	None
He was given Levo 750 mg PO X1 , and Flagyl 500 mg PO X1 .	None
A cosyntropin stimulation test revealed cortisol 32.1 --> 36.4 .	None
He is being transferred to the floor for ongoing care .	None
He later presented with increasing back pain , and metastatic disease was documented .	None
ongoing grade III rash , involving the hands and feet in addition proteinuria secondary to the Avastin .	None
He works in real estate development and invests in stockmarket .	None
GEN : In NAD .	None
RESP : Decreased air entry and crackles at both lung bases .	None
No S3 , S4 .	None
GI : BS NA .	None
2019-06-14 10:30 AM BLOOD Glucose - 134 * UreaN - 39 * Creat - 2.1 * Na - 133 K - 7.9 * Cl - 94 * HCO3 - 28 AnGap - 19	None
2019-06-14 10:30 AM BLOOD CK-MB - 3 cTropnT - 0.05 *	None
Discharge was delayed by one day to ensure patient could tolerate P.O. which patient did without difficulty .	None
Signed electronically by : DR. Clara M. Odell on : WED 2013-06-26 9:58 AM	None
( End of Report )	None
a 5 cm laceration was noted over the patient 's occiput on test with no problem .	TeRP
given problem , test was performed on 2010-06-28 and demonstrated no evidence of major arterial or venous injury in the level of	TeCP
right lower extremity examination demonstrated problem1 and problem2 and approximately a 3 cm laceration in the lower leg , expressive of moderate amounts of standard sterile	PIP
problem1 was noted to be clean , dry , and intact with sutures intact and no problem2 or purulence noted .	PIP
test demonstrated no evidence of problem .	TeRP
in addition , the patient received the above-described test , which demonstrated injuries limited to a posterior scalp laceration , problem , left fractured radius , right thigh hematoma , and right leg laceration .	TeRP
in addition , the patient received the above-described test , which demonstrated injuries limited to a posterior scalp laceration , left fractured clavicle , problem , right thigh hematoma , and right leg laceration .	TeRP
in addition , the patient received the above-described diagnostic procedures , which demonstrated problem1 limited to a posterior scalp laceration , left fractured clavicle , problem2 , right thigh hematoma , and right leg laceration .	PIP
test demonstrated problem , but no pelvic fracture .	TeRP
test demonstrated mild pulmonary contusions , but no problem .	TeRP
treatment was elected for problem .	TrAP
The vehicle was noted to be extensively damaged .	None
By report , the patient was noted to be awake , but confused at the scene of the accident with no memory of the incident .	None
Tympanic membranes were noted to be clear .	None
Cardiac examination demonstrated regular rate and rhythm , no murmurs , rubs , or gallops .	None
the right inguinal region .	None
Nonoperative treatment was elected for the patient 's left clavicular fracture .	None
The left forearm dressing was noted to be in place , clean , dry , and intact with no saturation .	None
Sensation was intact in the median , radius , and ulnar-nerve distributions .	None
2. Left midclavicular fracture managed nonoperatively .	None
Percocet one to two tablets PO q.4h. to 6h.p.r.n. pain .	None
6. Acetaminophen 325 mg Tablet Sig : 1-2 Tablets PO Q4-6H ( every 4 to 6 hours ) as needed .	None
8. Ferrous Sulfate 325 ( 65 ) mg Tablet Sig : One ( 1 ) Tablet PO DAILY ( Daily ).	None
9. Aspirin 81 mg Tablet , Chewable Sig : One ( 1 ) Tablet , Chewable PO DAILY ( Daily ).	None
Disp :* 135 Tablet (s)* Refills :* 2 *	None
Signed electronically by : DR. Joyce Arney on : MON 2018-12-03 10:55 PM	None
as for the patient 's all and problem , the patient was started on a new chemotherapy protocol called treatment on 2012-03-06 .	TrAP
as for the patient 's problem1 and problem2 , the patient was started on a new chemotherapy protocol cproblem1ed hyper-cvad on 2012-03-06 .	PIP
The Whidden Memorial Hospital hospital course has been smooth with the patient progressively improving .	None
The patient was initially on several antibiotics included Cefepime , Vancomycin , Ciprofloxacin , Ambazone and Flagyl .	None
The patient 's HSV antibody titer was found to be negative and the patient 's Acyclovir was not restarted .	None
The patient was discharged to home in good condition .	None
The patient is to return to the hospital on Monday for follow-up .	None
while the patient was in restraints , treatment was initiated since p.o. intake was problem .	TrAP
he has a history of problem1 , kidney transplantation in 2003 secondary to problem2 , as well as throat cancer in 2004 treated with local resection and radical neck dissection on the left as well as postoperative radiation .	PIP
there were no problem2 that could explain problem1 .	PIP
he was awake , alert , problem1 secondary to problem2 at neck site as well as right iliac graft site .	PIP
no definite evidence for problem , although test were sent and he ruled out for myocardial infarction .	TeCP
treatment as well as intravenous haldol were ordered p.r.n. for emergency use should he become problem .	TrAP
the etiology for problem1 was determined likely to be diastolic dysfunction from increased heart rate as well as problem2 .	PIP
he has a history of peripheral neuropathy , treatment in 2003 secondary to problem , as well as throat cancer in 2004 treated with local resection and radical neck dissection on the left as well as postoperative radiation .	TrAP
liver function tests were checked , only test was problem at 1.6 .	TeRP
the likely cause of problem was a combination of surgery and intensive care unit stay in addition to treatment .	TrCP
7. problem status post treatment ; self catheterization .	TrAP
the patient became problem with both tent and treatment , although continued to saturate well .	TrCP
6. problem1 with problem2 , retinopathy , neuropathy , nephropathy .	PIP
he has a history of peripheral neuropathy , kidney transplantation in 2003 secondary to diabetic nephropathy , as well as problem in 2004 treated with local resection and treatment as well as postoperative radiation .	TrAP
HISTORY OF PRESENT ILLNESS :	None
He was awake , alert , uncomfortable secondary to incisional tenderness at neck site as well as right iliac graft site .	None
A head and neck CT scan , non-contrast , were ordered though to evaluate for such processes .	None
The patient was found out of bed but no signs of head trauma , no loss of consciousness .	None
The likely cause of the delirium was a combination of surgery and Intensive Care Unit stay in addition to poly-pharmacy .	None
His immunosuppressive therapy was continued throughout his stay ; his creatinine remained approximately 2.3 to 2.4 ; he has a baseline renal insufficiency .	None
2. Follow-up with Dr. Michael , his psychiatrist , on Wednesday , 09-08 .	None
2. Furosemide 20 mg q.o.d.	None
7. Zithropren 50 mg q. day .	None
test trended toward normal and the fractional excretion of sodium also increased indicating a resolution of problem .	TeRP
his creatinine levels trended toward normal and test also increased indicating a resolution of problem .	TeRP
gram stain and test of the ascites failed to identify problem .	TeRP
treatment and midodrine were also given for problem and he also received packed red blood cells .	TrAP
problem , which is identified previously by endoscopic retrograde cholangiopancreatography , and regional lymph nodes were all sent to test .	TeCP
test revealed minimal left base atelectasis and problem .	TeRP
test was also negative for problem .	TeRP
HISTORY OF PRESENT ILLNESS :	None
Mr. Cordano is a 58-year-old gentlemen with a past medical history significant for primary sclerosing cholangitis who presented with a chief complaint of endoscopic retrograde cholangiopancreatography endoscopic retrograde cholangiopancreatography and percutaneous transhepatic cholangiogram .	None
The most recent percutaneous transluminal coronary angioplasty was done in 2009-07-25 .	None
The neck is supple with no lymphadenopathy .	None
The chest is clear to auscultation bilaterally .	None
The heart has a regular rate and rhythm with normal S1 , S2 .	None
Sodium of 130 , potassium 3.5 , chloride 93 , bicarbonate 28 , BUN 15 , creatinine 1.1, prothrombin time 14.1 , partial thrombin time 29.7 .	None
On exploration of the abdomen revealed significant nodularity of the liver indicating of advanced cirrhosis .	None
The patient 's postoperative course was notable for an elevation in white blood cell count peaking at 30.0 on postoperative day number two .	None
He also had significant lower extremity and scrotum edema .	None
At the time he took good po .	None
on test , the patient is problem .	TeRP
because of his confusion , a neurology consult was obtained and test revealed chronic appearing infarcts in the right occipital lobe as well as both cerebellar hemispheres , suggestive of more chronic infarcts , as well as an area in the left corona radiata , adjacent to the left lateral ventricle which may or may not be problem .	TeRP
on the 16th , test was obtained and did grow out greater than 100,000 colonies of problem which was intermittently resistant to ciprofloxacin .	TeRP
on the 16th , a urine culture was obtained and did grow out greater than 100,000 colonies of problem which was intermittently resistant to treatment .	TrWP
a right upper quadrant ultrasound did not reveal any gallstones or problem1 indicative of problem2 or cholelithiasis .	PIP
test did not reveal problem or common bile duct dilatation indicative of cholecystitis or cholelithiasis .	TeRP
a psychiatric consult was also obtained due to his mental status and confusion postoperatively but problem1 are mostly related to his neurologic insults and he has no distinctive psychiatric disorder , except for perhaps problem2 .	PIP
the patient had problem1 on 01-05 for history of problem2 , which was pan sensitive .	PIP
he has remained without any chest pain following this procedure and problem is clean , dry and intact at the end of treatment .	TrCP
briefly , the patient was taken to the operating room to treatment problem , his coronary artery disease and his significantly dilated ascending aortic aneurysm .	TrAP
in addition , he has problem , for which he receives treatment and he has hypercholesterolemia , for which he receives nothing at this time .	TrAP
HISTORY OF PRESENT ILLNESS :	None
Review of systems shows that the patient denies any orthopnea , paroxysmal nocturnal dyspnea .	None
Weight is 82 kilograms .	None
Heart was regular rate and rhythm .	None
Once consent and preoperative evaluation was complete , he was taken to the operating room .	None
After an extended stay for hemodynamic monitoring and pressor support to maintain his perfusion .	None
As the patient became more awake , he still remained somewhat confused and a little bit out of it .	None
on hd#6 , test was performed for decompression , and revealed pseudomembrane and problem .	TeRP
her abdomen remained problem and distended despite attempted treatment .	TrWP
sigmoid diverticulosis with problem1 just distal to problem2 with wall thickening , due to diverticulitis .	PIP
pod# 23/14 she recieved test which revealed no problem .	TeRP
she was taken to the or for subtotal colectomy , g tube and treatment due to problem to non-operative treatment .	TrAP
she was taken to the or for subtotal colectomy , g tube and ileostomy due to problem to treatment .	TrCP
2. problem2 , which appears to communicate with the sutured end of the proximal sigmoid colon via problem1 .	PIP
on pod#8 a ct scan was obtained which revealed problem1 with problem2 .	PIP
she was followed by cape cod hospital clinic for treatment of problem .	TrAP
continues to have problem , and recieves treatment .	TrAP
s/p exploratory laparotomy , resection of small intestine with primary anastomosis , sigmoid colectomy , treatment of problem	TrAP
03-21 test - no problem	TeRP
she recieved further resection of remaining colon , treatment of problem and treatment of colovesicular fistula .	TrAP
Major Surgical or Invasive Procedure :	None
2. Completion sigmoid colectomy , repair of colovesicular fistula , small bowel repair	None
The other daughter was recently in a car accident and underwent surgery at Saint Vincent Hospital .	None
2014-03-10 05:25 PM BLOOD cTropnT - 0.42 *	None
2. Limited evaluation for known sigmoid-vesicle fistula .	None
Due to atherosclerosis , assessment of the intraluminal process of these branches is limited .	None
In the correct clincial setting , this could be consistent with an abscess .	None
4. Status post ileostomy without evidence of small-bowel obstruction .	None
Cardiovascular : Complained of chest pain during first few days of admission , a cardiology consult was obtained .	None
a/p : 48yo man with h/o hcv , bipolar do , h/o suicide attempts , a/w problem of treatment , klonopin , geodon , s/t jackson stay with intubation for airway protection , with question of l retrocardiac infiltrate , now doing well .	TrCP
Patient recorded as having No Known Allergies to Drugs	None
Major Surgical or Invasive Procedure :	None
Per report , there were empty bottles of Inderal and Klonopin found at bedside , as well as 02-26 full bottles of geodon , gabapentin , Lescol and paroxitine .	None
His initial BP was 60/P with a pulse in the 60 s.	None
No history of head trauma or seizure disorder	None
Has a history of qualude use since high school , also in remission .	None
Abd : normal size , nd , no scars , nl bs , soft , nt , palp liver	None
2012-06-08 09:30 AM BLOOD WBC - 10.1 RBC - 4.35 * Hgb - 14.2 Hct - 39.9 * MCV - 92 MCH - 32.6 * MCHC - 35.6 * RDW - 12.4 Plt Ct - 151	None
1. problem status post treatment with a #21 mosaic porcine valve	TrAP
HISTORY OF PRESENT ILLNESS :	None
4. Noninsulin dependent diabetes mellitus	None
Head , eyes , ears , nose and throat :	None
Pupils equal , round and reactive to light , extraocular movements intact , anicteric , not injected .	None
Supple , no lymphadenopathy , no jugular venous distention , no thyromegaly .	None
Femoral 2 + bilaterally , dorsalis pedis 1 + bilaterally , posterior tibial 1 + bilaterally , and radial 2 + bilaterally .	None
After being transferred to the floor , the patient did well .	None
there is problem1 through an inferior branch of the left anterior descending to problem2 and a persistent branch of the circumflex to pa branch fistula which anatomically were not suitable for coil embolization .	PIP
1. problem status post treatment .	TrAP
test demonstrates no problem .	TeRP
HISTORY OF PRESENT ILLNESS :	None
The patient is in no acute distress .	None
Temperature is 98.3 F. ; pulse is 76 ; blood pressure 113/52 ; breathing 18 ; 98% on room air .	None
The patient is missing many teeth .	None
His lungs are clear to auscultation bilaterally .	None
There is a persistent flow through an inferior branch of the left anterior descending to PA fistula and a persistent branch of the circumflex to PA branch fistula which anatomically were not suitable for coil embolization .	None
The patient was corrected to a normal pH of 7.41 by the first postoperative night and remained stable .	None
He was then weaned off of ventilatory support and was successfully extubated .	None
mr. andersen is a 71-year-old male with problem who underwent test that showed severe three-vessel disease .	TeCP
mr. andersen is a 71-year-old male with worsening anginal symptoms who underwent test that showed problem .	TeRP
He is presenting for revascularization .	None
Father died of colon cancer .	None
Mother with pacemaker , alive at 91 years old .	None
HEENT : PERRLA , no carotid bruits	None
2013-10-29 11:37 AM BLOOD WBC - 11.4 *# RBC - 3.09 *# Hgb - 9.1 *# Hct - 27.5 *# MCV - 89 MCH - 29.5 MCHC - 33.3 RDW - 14.6 Plt Ct - 180	None
Please see operative note for full details .	None
The patient tolerated this procedure well .	None
On post-op day #3 , the patient 's pacing wires were removed , and his lopressor was started .	None
He was seen and cleared by physical therapy .	None
Disp :* 30 Capsule , Sust. Release 24 HR (s)* Refills :* 0 *	None
pt has h/o problem , s/p treatment with serosal implants in 9/03 .	TrAP
6. treatment 325 mg tablet sig : two ( 2 ) tablet po q6h ( every 6 hours ) as needed for fever or problem .	TrAP
11. treatment 5 mg tablet sig : 1-2 tablets po every 4-6 hours as needed for problem for 14 days .	TrAP
test was done and this showed a signal abno in l3 l4 ? problem vs osteo without a definitive epidural abscess .	TeRP
test was done and this showed a signal abno in l3 l4 ? disciitis vs problem without a definitive epidural abscess .	TeRP
states he first developed problem 5 weeks ago but was still able to ambulate with treatment .	TrAP
treatment c/d/i over problem .	TrAP
chest : treatment , no erythema or problem .	TrCP
test ( youville hospital 2020-03-09 ): problem with moderate l pleural effusion .	TeRP
# pleural effusion : the patient was noted have problem on test .	TeRP
# problem :  the patient was noted to have a positive test from 03-12 .	TeRP
outpatient course and treatment if the pt becomes symptomatic 02-07 problem .	TrAP
Major Surgical or Invasive Procedure :	None
1. Partial vertebrectomy of L3 and L4 .	None
5. Autograft , bone morphogenic protein , and allograft .	None
History of Present Illness :	None
He did undergo a CT-guided aspiration / biopsy at the L3-4 disc space on 2020-03-11 and the pt was transferred to Mediplex Rehab Hospital immediately following this .	None
- DM with neuropathy .	None
Quit tobacco in 2003 after smoking 1 ppd for " a very long time ".	None
ABD : Pt very tense in abdomen ( states belly is fine , but he is weary of his back ).	None
5/5 strength throughout , though weary of moving back .	None
No erythema or swelling noted .	None
CXR ( Youville Hospital 2020-03-09 ): Persistent unchanged L mid and lower lung field airspace disease with moderate L pleural effusion .	None
# Epidural abscess : The patient was evaluated by orthopedic spine consult service and ID .	None
the hospitalisation was also significant for problem for which she received treatment and uti (+ enterococcus and + klebsiella ).	TrAP
test with na of 10 indicating either pre-renal or problem .	TeRP
pt previously diagnosed with problem and was started on treatment , octreotide and albumin ; these were 	TrAP
pt previously diagnosed with problem and was started on midodrine , octreotide and treatment ; these were 	TrAP
# anemia : problem following treatment and there was concern for bleed into her abdomen .	TrCP
test showed no evidence of problem .	TeRP
a/p : 48 yo morbidly obese woman with problem1 c/b encephalopathy , problem2 and partial vein thrombosis ( but no hx of sbp ) presents with increasing abdominal girth likely secondary to ascites .	PIP
# hypotension : pt became problem following treatment despite replacement with albumin .	TrCP
# problem : pt became hypotensive following treatment despite replacement with albumin .	TrCP
# problem : pt became hypotensive following the large volume paracentesis despite treatment .	TrWP
47 female with h/o problem1 compocated by problem2 , ascites , and h/o portal vein thrombosis ( right anterior portal vein ) and portalcaval shunt ( reversed flow in main portal vein ) presents from liver clinic with increasing abdominal girth .	PIP
abdomen : obese , soft , mildly distended dull to percussion throughout , no tenderness , problem1 due to problem2	PIP
she was recently hospitalised from 02-23 / 03-04 for problem at which time she underwent treatment that ruled out sbp and relieved her abdominal pain .	TrIP
her mental status also had decreased from admission and test was problem , 225cc over the past 12 hours .	TeRP
abdomen : obese , soft , mildly distended problem to test throughout , no tenderness , liver non-palpable due to large volume of ascited	TeRP
Attending : Terry T Trott , M.D.	None
She also described sob , nausea , worsening lower ext edema .	None
She was admitted for a large volume paracentesis but her INR on admission was 3.8 .	None
Over the next several hours , pt complained of abd pain but this resolved on its own without medication .	None
Creatinine this am was 1.9 from 0.9 yesterday .	None
She also underwent US that revealed patent portal and hepatic vessels .	None
She has a history of heavy alcohol use .	None
Neck : No Donna , normal thyroid contour	None
# Liver cirrhosis : MELD score of 34 on admission .	None
# Recurrent ascites : On the medical floor , pt had a large volume paracentesis ( 6 liters ) followed by replacement with albumin .	None
# Anemia : Hct dropped following the tap and there was concern for bleed into her abdomen .	None
CT of the abdomen and pelvis showed no evidence of bleed .	None
1. problem , mother was treated in 2001 according to chart with subsequent negative test , and	TeCP
problem1 consistent with problem2 in the b co-twin .	PIP
Maternal blood type 0-positive , DAT negative , negative , RPR nonreactive .	None
thickening consistent with Trisomy 21 in the B co-twin .	None
Twin #1 was noted to be in a breech presentation .	None
Positive suck , positive grasp .	None
Size appropriate for gestational age , 32 week female .	None
SUMMARY OF HOSPITAL COURSE :	None
Gerardo weaned to room air on day of life #6 .	None
Breath sounds , clear and equal , without retractions , respiratory rate 30 s to 60 s.	None
2. Cardiovascular - The patient has been cardiovascularly stable without murmur .	None
The patient was initially started on D10 / W at 80 cc / kg / day .	None
No hypoglycemia issues noted .	None
8. Sensory - Audiology , hearing screening was performed with automated auditory brain stem responses .	None
A follow up examination is recommended in six to eight months .	None
The contact social worker is Barbara Cole and she can be reached at ( 972 ) 433-8086 .	None
this is a 49-year-old gravida iii , para ii , status post uterine artery embolization on 2009-01-07 due to uterine fibroids , with continued abdominal pain and test revealing problem .	TeRP
this is a 49-year-old gravida iii , para ii , status post uterine artery embolization on 2009-01-07 due to uterine fibroids , with problem and test revealing fluid and gas in the endometrial cavity .	TeCP
she has had problem2 , and was diagnosed with problem1 one day prior to admission , and was given a prescription for flagyl .	PIP
on hospital day number three , her blood cultures came back problem1 in the anaerobic culture for gram-problem1 cocci in pairs and clusters .	PIP
she was sent for a ct scan of her abdomen , which revealed problem and question of gas in the endometrial cavity , and she was sent to pinewood , norfolk for treatment and treatment .	TrAP
she was sent for a ct scan of her abdomen , which revealed fluid and question of problem , and she was sent to pinewood , norfolk for treatment and treatment .	TrAP
she was sent for test , which revealed problem and question of gas in the endometrial cavity , and she was sent to pinewood , norfolk for treatment and admission .	TeRP
Last menstrual period 2009-02-21 .	None
Some spotting on the day prior to admission , but not a normal period .	None
Cesarean section x 2 , dilatation and curettage x 1 , neck fusion after motor vehicle accident , shoulder surgery after motor vehicle accident .	None
No smoking , alcohol or drugs .	None
Repeat blood cultures were sent .	None
Her white blood cell count was 12.8 , with a normal differential .	None
Claude U Bolanos , M.D.	None
Signed electronically by : DR. Suzanne Simpson on : FRI 2009-04-24 12:48 PM	None
if signs and symptoms of problem1 , such as fevers / chills , purulent discharge from wound / incision site , increased redness , problem2 , please call or go to the emergency room .	PIP
if signs and symptoms of problem1 , such as fevers / chills , problem2 , increased redness , increased pain , please call or go to the emergency room .	PIP
please clean incision site with normal saline or clean water three times a day and place treatment ( given ) on top of problem .	TrAP
ms. marshall is a 64-year old , mentally retarded , female who presented with problem2 after problem1 was resected by dermatology .	PIP
problem1 has remaind dry and closed , without evidence of infection or problem2 .	PIP
ACQUIRED DEFECT FROM BASAL CELL CARCINOMA RESECTION	None
ON PRESENTATION , PT WAS AFEBRILE WITH NORMAL VITAL SIGNS	None
GEN : NO ACUTE DISTRESS , ABLE TO COMMUNICATE AND FOLLOW ORDERS	None
ABDOMEN : SOFT , NON-TENDER , NON-DISTENDED	None
UPON ADMISSION , THE PATIENT WAS PRE-OP 'D AND MADE NPO / IVF .	None
1. Paroxetine HCl 10 mg Tablet Sig : One ( 1 ) Tablet PO AM ().	None
2. Multivitamin Capsule Sig : One ( 1 ) Cap PO QAM ( once a day ( in the morning )).	None
IF SIGNS AND SYMPTOMS OF INFECTION , SUCH AS FEVERS / CHILLS , PURULENT DISCHARGE FROM WOUND / INCISION SITE , INCREASED REDNESS , INCREASED PAIN , PLEASE CALL OR GO TO THE EMERGENCY ROOM .	None
PLEASE CALL DR.Parson OFFICE FOR A FOLLOW UP ( 989-5361 Mauricio ( 540-4644	None
Completed by : Mary Lisa MD 53-914 2013-11-26 @ 1134	None
7) gi : ms. pimental is an unfortunate 95 year old woman , status post a recent fall necessitating right treatment of the hip and problem treatment , who was in the hospital for this event , when it was noted that she had abdominal pain , distention and coffee ground emesis with worsening mental status and renal failure .	TrAP
2. problem1 , right greater than left , with problem2 .	PIP
1. test with drainage of intra-abdominal abscess and problem with gross soilage with bile and gastric contents .	TeRP
3. left ventriculography was not performed due to the presence of problem ( test 1.6 ).	TeRP
problem was present with test of 52/28 .	TeRP
test neg for problem , bleed , and dislocation .	TeRP
1. a small amount of problem2 , mostly along the right pericolic gutter and surrounding the ascending colon , concerning for problem1 .	PIP
She fell on her R side and had a great deal of pain in her R arm and hip .	None
9. History of syncope and first degree A-V heart block with beta blocker therapy .	None
Lives alone in elderly housing , a daughter in the area , two children and exercises two times a week by walking and stretching .	None
1. The left atrium is moderately dilated .	None
The left ventricular cavity size is normal .	None
Resting regional wall motion abnormalities include inferolateral , inferior and mid septal hypokinesis .	None
Right ventricular systolic function is normal .	None
5. The mitral valve leaflets are mildly thickened .	None
The left main was normal .	None
cholangiopancreatography with problem to treatment and tongue injury .	TrCP
cholangiopancreatography with problem2 to fentanyl and problem1 .	PIP
there were no problem , which required treatment .	TrAP
she had test , which showed problem .	TeRP
The patient was in her usual state of health until four days prior to admission when she had a cholecystectomy .	None
After her endoscopic retrograde cholangiopancreatography the patient developed " jaw clenching , biting tongue , rigidity and cold / chills ."	None
No murmurs , rubs or gallops .	None
There were normoactive bowel sounds .	None
There were post laparoscopic incisions without erythema with Steri-Strips in place .	None
Dorsalis pedis pulses were intact bilaterally .	None
There were no rashes .	None
Abdominal CT showed inflammation in the right upper quadrant , small fluid in the circumferential thickening of the distal stomach .	None
There was a tiny amount of free air .	None
She then suffered rigidity with jaw clenching and tongue biting secondary to Fentanyl administration and was transferred to the CMED CCU for close observation .	None
On the second hospital day the patient was doing much better and was stable from an airway perspective , so she was transferred to the General Medical Floor .	None
The patient was continued on Ampicillin , Gentamycin and Flagyl , which had been started at the time of transfer to the CMED CCU .	None
the patient went for test which showed no change in problem .	TeCP
a hepatology consult was obtained who felt that the most likely etiology of problem1 were from problem2 , although one could not rule out lymphoma involving from burkitt's .	PIP
a hepatology consult was obtained who felt that the most likely etiology of problem1 were from hepatic candidiasis , although one could not rule out problem2 involving from burkitt's .	PIP
test remained problem despite discontinuing her g-csf .	TeRP
she will be discharged on treatment 300 mg iv q.d. for treatment of problem .	TrAP
She will be discharged on AmBisome 300 mg IV q.d. for treatment of her hepatic candidiasis .	None
This regimen , that being AmBisome , was recommended by the Infectious Disease physicians , who felt that AmBisome was a better drug of choice as compared to fluconazole .	None
6. Nystatin 06-18 mL swish and swallow q.6. prn .	None
7. Peridex 15 mL swish and swallow prn .	None
Signed electronically by : DR. Richard Blakey on : FRI 2011-12-23 9:54 AM	None
infectious disease department as well as cardiology had recommended a formal 14 - day course of treatment to treat problem from outside hospital blood cultures .	TrAP
test revealed an abdomen that is problem , nontender .	TeRP
mr. eugene is a 67 year old male with a remote history of chronic pancreatitis due to alcohol abuse 30 years ago , who is transferred now from rehab hospital of the cape & islands hospital for an ercp and test for problem at the head of his pancreas on ct scan shown at the outside hospital .	TeCP
an ultrasound showed normal gallbladder with no wall thickening but problem of 8 mm measured on test .	TeRP
test showed normal gallbladder with no wall thickening but problem of 8 mm measured on ct scan .	TeRP
he also had treatment of problem .	TrIP
test revealed trace glucose , no problem , no red cells , no white cells and less than one epithelial cells .	TeRP
the results of this study indicated that this structure at the head of his pancreas is most likely a forming pseudocyst ; however , the suspicion of problem is still possible and the patient underwent test of this mass on 2011-01-20 .	TeCP
the results of this study indicated that this structure at the head of his pancreas is most likely a forming pseudocyst ; however , the suspicion of problem1 is still possible and the patient underwent an ultrasound guided biopsy of problem2 on 2011-01-20 .	PIP
he was also found to have problem2 with calcifications consistent with problem1 .	PIP
he was also found to have dilated pancreatic ducts with problem2 consistent with problem1 .	PIP
he had test which revealed no problem .	TeRP
While at home , the patient did not do well and could tolerate minimal food intake and lost about 20 pounds in one month .	None
A chest x-ray was unremarkable .	None
3. Humalog 75/25 , subcutaneously .	None
He is a retired painter .	None
The patient was alert , awake and oriented , pleasant , and in no acute distress .	None
Cardiovascular system revealed normal S1 and S2 , no murmurs or gallops and regular rate and rhythm .	None
In the Medicine Intensive Care Unit , the patient was initially placed on high-flow 60% oxygen face mask and they diuresed approximately 5 liters off into the intravenous Lasix .	None
The patient actually was improved .	None
Hypotension - On the night of 10-16 , the patient was diuresed with 20 mg of intravenous Lasix .	None
Her oxygen saturations were greater than 94% at the time .	None
upon transfer to the cmed ccu the patient appears problem1 , reporting problem2 and abdominal pain , but when questioned he was unable / unwilling to participate in hpi or exam d/t sleepiness .	PIP
pt discharged home on 01-24 with instructions to complete 2 week course of treatment at hemodialysis for problem .	TrAP
in the cmed ccu he became problem to test 80 s.	TeRP
also had problem1 with repeated episodes of problem2 , and strickland recommended sugars in the range of 150-200 .	PIP
# treatment : pt with h/o problem in treatment .	TrCP
he eloped prior to formal discharge when test was found to be problem - recommended to patient that he stay for repeat , but left ama without signing any forms .	TeRP
patient recorded as having no problem to treatment	TrCP
5. problem1 with problem2 ( 50% stenosis d1 in 2014-06-07 ), normal stress	PIP
test returned positive with problem , so a tte and surveillance cultures were ordered and vancomycin was started .	TeRP
11. treatment 5 mg tablet sig : one ( 1 ) tablet po once a day as needed for problem .	TrAP
Attending : Antonio I Staples , M.D.	None
He was given ativan a total of 4 mg of ativan , 6 mg of dilaudid , labetolol 20 mg IV x 1 and hydralazine 10 mg IV x 1 without good response ( 200/99 ).	None
3. Severe autonomic dysfunction with multiple hospitalizations for hypertensive emergency , gastroparesis , and orthostatic hypotension .	None
Endorses occassional marijuana use .	None
His mother is in her 50 s and has hypertension .	None
HEENT : PERRL , left pupil smaller than right , pt will not participate in EOMI , sclera anicteric , MM dry , No OP lesions	None
CV : RRR , nl S1 , S2 , 2/6 systolic murmur at LUSB	None
No evidence of active end organ damage .	None
pt with 2/4 bottles coag neg staph on 01-19 and again on 01-20 .	None
the patient was seen by the wound care nurse and problem2 was felt to be mild , but was causing the patient a lot of problem1 and the wound care nurse ivy rose lidocaine jelly .	PIP
The patient overall continued to improve , but remained physically decompensated and the patient was transferred to Waltham/Weston Hospital Rehabilitation Hospital for intensive physical therapy .	None
DISCHARGE MEDICATIONS are the same with the addition of viscous lidocaine jelly to be applied to buttock prn and viscous lidocaine swish and swallow tid prn before meals .	None
( End of Report )	None
it was believed that a troponin on admission in addition to the wall motion abnormalities she underwent problem1 prior to resulted in problem2 .	PIP
given her hypertension which was very difficult to control , it was felt that she had renal artery stenosis and thus she underwent test which showed problem .	TeRP
however , test has problem up to 4.2 .	TeRP
3. problem status post treatment .	TrAP
She has noted increased urinary frequency .	None
Denies fever or chills .	None
Of note , she has had recent medication changes which included discontinuing Diovan and starting terazosin .	None
2. Norvasc 10 mg p.o. q. day .	None
4. Terazosin 1 mg p.o. q. day .	None
The patient lives alone .	None
Has a remote tobacco history .	None
On admission , blood pressure 151/61 , heart rate 75 , SaO2 93% on room air .	None
Included normal CBC , BUN 47 , creatinine 2.4 up from baseline of about 1.5 .	None
Chest x-ray showed patient was in congestive heart failure .	None
However , no acute changes were apparent .	None
patient was admited , problem was managed with a pca and later with treatment .	TrAP
problem1 was stable , no sign of rupture or problem2 , did not required surgical managment .	PIP
problem was stable , no sign of rupture or further complication , did not required treatment .	TrAP
the liver laceration was stable , no sign of problem or further complication , did not required treatment .	TrAP
chest clear to test bilateral , s1 s2 normal and with no problem .	TeRP
ALT(SGPT) - 318 * AST(SGOT) - 307 * ALK PHOS - 61 TOT BILI - 0.9	None
The liver laceration was stable , no sign of rupture or further complication , did not required surgical managment .	None
Completed by : Jane Ashmore MD 50-063 2017-08-16 @ 0950	None
he is a 39 year-old gentleman with hyperlipidemia and smoking who presented with acute onset of problem1 since five in the morning with radiation to the left arm and problem2 .	PIP
3. Fatty liver resolved .	None
He works as a jeweler .	None
The patient was diagnosed as having an acute myocardial infarction .	None
His chest tube had been discontinued .	None
2. Lipitor 20 milligrams po q HS .	None
DISCHARGE FOLLOW UP : The patient is to follow up with Dr. Debra Oneal , his PCP and his cardiologist in 3 weeks .	None
problem was well controlled with treatment at this time .	TrIP
His Penrose drain was discontinued at this time .	None
in tsicu , developed mrsa pneumonia with question of aspiration , treated zosyn --> vanc / levo --> then 2 week course of treatment with resolution of fevers and problem .	TrIP
in tsicu , developed mrsa pneumonia with question of problem , treated zosyn --> treatment / levo --> then 2 week course of linazolid with resolution of fevers and decreased pulmonary secretions .	TrAP
conclusion : improvement in problem1 from problem2 with no worsening , but no significant improvement , in the right upper lobe pneumonia .	PIP
problem1 w/ problem2	PIP
test : there are problem .	TeRP
also noted is problem1 and problem2 , likely chronic inflammatory 	PIP
this could represent either problem or an intraventricular mass , and further evaluation with test , when clinically feasible , is recommended .	TeCP
Lives with wife ; +ETOH use	None
Positioning limits assessment of alignment due to extreme head tilting to the right , but this is likely the best obtainable secondary to intubation and nasogastric tube placement .	None
NOTE : This study was initially performed on the morning of 10-21 , and is being dictated on the morning of 10-22 due to PACS malfunction .	None
There is diffuse brain atrophy and chronic microvascular infarction throughout the white matter .	None
There is no evidence of subarachnoid hemorrhage or acute major vascular territorial infarction .	None
The ventricles do not appear dilated relative to the sulci , and there is no shift of normally midline structures .	None
Opacified and sclerotic left mastoid air cells are noted .	None
2. treatment 5 mg tablet sig : two ( 2 ) tablet po q4h ( every 4 hours ) as needed for problem .	TrAP
right tibia / fibula , ap and lateral views : an intramedullary rod is seen fixating problem with treatment .	TrAP
impression : problem1 extending into the mastoid process with small associated right posterior convexity subdural hematoma and problem2 .	PIP
2) problem1 extending into the mastoid with problem2 and pneumocephalus ; see head ct report .	PIP
17 yo male pedestrian who was struck by auto at unknown speed ; +LOC .	None
He was medflighted to The Hospital for Orthopedics for ongoing trauma care .	None
UREA N - 12 CREAT - 1.0	None
Reason : STUCK BY AUTO	None
56 year old man s/p struck by auto	None
No other acute fractures are appreciated .	None
56 year old man s/p struck by auto	None
Head injury to the occiput .	None
The posterior elements are intact .	None
There is no significant prevertebral soft tissue swelling .	None
The dens is intact .	None
There is a linear right temporal calvarial fracture extending into the right temporal bones .	None
Reason : Please r/o acute process .	None
REASON FOR THIS EXAMINATION :	None
Please r/o acute process .	None
ultrasound was performed on 2014-04-01 demonstrating problem2 with problem1 and splenorenal shunt .	PIP
ultrasound was performed on 2014-04-01 demonstrating problem with massive peri splenic varices and treatment .	TrAP
the patient is a 49 year-old man with hepatitis c cirrhosis complicated by encephalopathy , positive esophageal varices , now with problem1 and problem2 .	PIP
today , on 2014-03-03 , the patient was seen in clinic with problem2 , problem1 .	PIP
there appears to be problem1 with problem2 .	PIP
The patient has been compliant with his medications .	None
He has had night sweats for the past 2 weeks .	None
Underwent treatment with Interferon 10 years ago .	None
Testosterone 4 mg q. 24 hours .	None
Alcohol : No alcohol use .	None
HEENT : Pupils equal , round and reactive to light .	None
Neck : No LAD .	None
Neurologic : Awake , alert and oriented x3 .	None
Patient continued on Lactulose .	None
problem1 complicated by problem2 , 2 vessel cord , normal fetal echo reverse diastolic flow and demise of twin a at 27 weeks .	PIP
pprom with bleeding and problem prompted treatment .	TrAP
rule out problem with treatment .	TrAP
immunizations : recommended treatment should be considered from november through march for infants who meet any of the following 3 criteria , born at less than 32 weeks , born between 32 and 35 weeks with 2 of the following , daycare during rsv season , a smoker in the household , neuromuscular disease and weight abnormalities or school age siblings with problem .	TrAP
HISTORY OF PRESENT ILLNESS :	None
Anterior fontanel soft , flat , cap and prong CPAP in place .	None
Blood pressure most recently 60/37 with a mean of 44 .	None
Infant achieved full enteral feedings by day of life 6 .	None
Her discharge weight is 1477 gm .	None
She has been appropriate for gestational age .	None
To Boston Medical Center .	None
Continue 150 cc per kilo per day of Special Care 20 calories advancing caloric intake as required to maintain weight gain of 3 grams per kilogram per day .	None
Car seat position screening has not yet been done .	None
Immunizations received , infant has not received any immunizations to date .	None
Immunizations : recommended Synagis RSV prophylaxis should be considered from November through March for infants who meet any of the following 3 criteria , born at less than 32 weeks , born between 32 and 35 weeks with 2 of the following , daycare during RSV season , a smoker in the household , neuromuscular disease and weight abnormalities or school age siblings with chronic lung disease .	None
the procedure team was called to consider doing a left thoracentesis , but she was declined because it was felt that problem1 were transudative , secondary to problem2 , and it was recommended to treat problem2 .	PIP
test consistent with problem , fena 4% .	TeRP
test : a paced at 70 bpm / nml axis , problem , no st or tw changes	TeRP
it was felt posthumously that her large pericardial effusion was most likely secondary to problem of treatment , although this was not seen on imaging .	TrCP
problem has increased despite treatment .	TrWP
test post procedure w/o pnx , problem much improved , yet her 05-28 cxr worse than 05-27 with some reaccumulation of right pleural problem .	TeRP
the ccu fellow and team declined to do treatment , as the pt was hemodynamically stable , without problem by echo performed at bedside by cards fellow .	TrNAP
she underwent test at erich lindemann mental health center today ( 05-26 ) showing mod-lg circumferential pericardial effusion without evidence of problem and no mv inflow evidence of tamponade , pacer wire located in rv apex .	TeRP
test revealed problem .	TeRP
test was performed the evening of 5/16 , showing moderate sized bilateral pleural effusions , stable cardiomegaly and a possible problem .	TeRP
pt now on iv ceftriaxone ( was on levoflox since 05-24 however test now problem ( more so than test at osh ) so felt possibly levo-resistant .	TeRP
82 y/o f w h/o problem1 , problem2 s/p pacer 05-08 c/b ptx requiring ct , cad , who was readmitted 05-24 with arf and lethargy , found to have a large pericardial effusion and bilateral pleural effusions , with echo showing no evidence of tamponade , who is transferred for possible pericardial effusion drainage and treatment of chf , as well as drainage of bilateral pleural effusions .	PIP
test at erich lindemann mental health center 05-26 : problem and pericardial eff	TeRP
problem2 , problem1	PIP
treatment placed 05-08 for sss with problem , c/b r ptx requiring chest tube	TrAP
82 y/o f w h/o afib , sss s/p pacer 05-08 c/b ptx requiring ct , cad , who was readmitted 05-24 with arf and lethargy , found to have problem and bilateral pleural effusions , with echo showing no evidence of tamponade , who is transferred for possible treatment and treatment of chf , as well as drainage of bilateral pleural effusions .	TrAP
82 y/o f w h/o problem , sss s/p treatment 05-08 c/b ptx requiring ct , cad , who was readmitted 05-24 with arf and lethargy , found to have a large pericardial effusion and bilateral pleural effusions , with echo showing no evidence of tamponade , who is transferred for possible pericardial effusion drainage and treatment of chf , as well as drainage of bilateral pleural effusions .	TrAP
pacer dddr ( vitatron cl860 ) placed 05-08 for sss with symptomatic bradycardia , c/b problem requiring treatment	TrAP
test at erich lindemann mental health center 05-25 : large pericardial effusion , problem with underlying consolidation which could represent pna vs. atelectasis	TeRP
She was then sent to Franklin Medical Center 05-24 with lethargy and n/v .	None
ext : 1+ LE edema	None
Bibasilar atelectasis is unchanged .	None
IMPRESSION : Unchanged moderate bilateral pleural effusions and mild CHF .	None
82 y/o f w h/o afib , SSS s/p pacer 05-08 c/b PTX requiring CT , CAD , who was readmitted 05-24 with ARF and lethargy , found to have a large pericardial effusion and bilateral pleural effusions , with echo showing no evidence of tamponade , who is transferred for possible pericardial effusion drainage and treatment of CHF , as well as drainage of bilateral pleural effusions .	None
A CXR was performed the evening of 5/16 , showing moderate sized bilateral pleural effusions , stable cardiomegaly and a possible RLL infiltrate .	None
It was felt that given her age , multiple co-morbidities , that her prognosis was poor even prior to CCU admission , possible pericardial drainage or repeat thoracenteses .	None
test revealed evidence of problem and pulm edema .	TeRP
problem1 : creatinine on admission was 1.6 likely problem2 plus probalbe long-standing hypertensive disease .	PIP
test demonstrated nsr at 87 bpm , nl axis , nl int , problem w/ strain pattern , no ischemic changes .	TeRP
test demonstrated nsr at 87 bpm , nl axis , nl int , lvh w/ problem , no ischemic changes .	TeRP
problem1 , and  particularly the left atrium accompanied by pulmonary vascular congestion and problem2 consistent with heart failure .	PIP
the right ventricular cavity is problem2 with problem1 .	PIP
there is problem1 with mild cavity dilation and problem2 .	PIP
46 - yo-man w/ cocaine abuse presents w/ problem1 and doe likely from problem2 in the setting of cocaine use complicated by hypertensive urgency .	PIP
46 - yo-man w/ cocaine abuse presents w/ le edema and problem1 likely from diastolic heart failure in the setting of cocaine use complicated by problem2 .	PIP
impression : problem1 with problem2 c/w diffuse process ( toxin , metabolic , cannot exclude myocarditis ; in the absence of lvh on ecg , an infiltrative process should also be considered ).	PIP
moderate to severe enlargement of the cardiac silhouette , and  particularly the left atrium accompanied by problem2 and mild pulmonary edema consistent with problem1 .	PIP
He denies any recent chest pain , palpitations , headache , confusion , weakness , numbness , abd pain , or hematuria .	None
He responded well to lasix w/ good UOP , but diastolic BP remained elevated at 170 , prompting initiation of nitroprusside gtt .	None
Drinks 3-4 beers a few times weekly , no h/o withdrawal symptoms , seizures or DT s.	None
There is no family history of premature coronary artery disease or sudden death .	None
Neck : Supple with JVP of 8 cm .	None
CK-MB - 4 proBNP - 7489 *	None
IMPRESSION : Moderate symmetric eft ventricular hypertrophy with severe global biventricular hypokinesis c/w diffuse process ( toxin , metabolic , cannot exclude myocarditis ; in the absence of LVH on ECG , an infiltrative process should also be considered ).	None
The patient was started on labetalol and Lisinopril .	None
She was treated with bed rest and prn terbutaline .	None
Anterior fontanel open and flat .	None
Neurologic : Appropriate tone and reflexes .	None
Beverly was initially NPO and maintained on intravenous fluids .	None
His maximum caloric intake was 24 calories per ounce .	None
His peak serum bilirubin occurred on day of life three with a total of 8.3 / 0.2 direct , 8.1 indirect mg/dl .	None
CARE AND RECOMMENDATIONS AT THE TIME OF DISCHARGE :	None
5. treatment - acetaminophen 5-325 mg tablet sig : 1-2 tablets po every 4-6 hours as needed for problem .	TrAP
he was seen by speech and swallowing who recommended npo , he then underwent a video swallow after which he was changed to treatment , and felt that his eeating may be limited by problem .	TrAP
shower , no baths , no lotions , creams or treatment to problem .	TrNAP
shower , no baths , no lotions , treatment or powders to problem .	TrNAP
60 yo m with exertional angina -> positive ett -> test with problem	TeRP
father with ? Mi at unknown age	None
lungs ctab ant / lat	None
He was taken to the operating room on 2019-10-01 where he underwent a CABG x 3 .	None
He was transferred to the CMED CCU in critical but stable condition .	None
Dentistry and OMFS were consulted , and he had four front teeth removed on 10-04 .	None
5. Oxycodone - Acetaminophen 5-325 mg Tablet Sig : 1-2 Tablets PO every 4-6 hours as needed for pain .	None
Disp :* 30 Tablet (s)* Refills :* 0 *	None
7. Atorvastatin 10 mg Tablet Sig : One ( 1 ) Tablet PO DAILY ( Daily ).	None
Disp :* 30 Tablet (s)* Refills :* 0 *	None
No lifting more than 10 pounds or driving until follow up with surgeon .	None
the patient was already on an aspirin and treatment should this represent problem .	TrAP
5. hematology : the patient was discharged on treatment for apical akinesis and problem .	TrAP
given the fact that the patient had significant problem , she was started on heparin with a transition to coumadin for anticoagulation for treatment in the setting of problem .	TrAP
however , there was no evidence for problem on test and this will be followed-up by her primary care physician .	TeRP
problem1 was intermittent through the day and then at 4:00 p.m. increased and was also associated with problem2 and diaphoresis .	PIP
the proximal lad was found to have problem1 with a septal branch with a 95% stenosis and a diagonal branch with problem2 .	PIP
The patient is a 57 - year-old female with a history of hypertension and hypercholesterolemia but no prior coronary artery disease history who presented with chest pain .	None
She reports that the pain shot through her back .	None
She arrived in the Emergency Room at 8:00 p.m.	None
ALLERGIES : The patient has no known drug allergies .	None
General : The patient was a well appearing female in no acute distress .	None
Abdomen : Soft , nontender , nondistended , good bowel sounds .	None
3. RHYTHM : The patient was monitored on telemetry throughout her hospitalization with no significant events .	None
DISCHARGE DIAGNOSIS : ST elevation myocardial infarction , status post left anterior descending artery stent .	None
6. Lovenox 60 mg b.i.d. until therapeutic on Coumadin .	None
the infant was started on ampicillin and treatment at the time of admission for problem .	TrAP
before this age , the family and other care givers should be considered for treatment against problem to protect the infant .	TrAP
This infant emerged with Apgars of 8 at one minute and 8 at five minutes .	None
Her lung sounds are clear and equal .	None
She is pink and well perfused .	None
She started on enteral feeds on day of life number two and progressed without difficulty to full volume feedings by day of life five and then was advanced to calorie enhanced breast milk of 24 calories per ounce .	None
She is receiving supplemental iron to provide 2 mg per kilo per day as elemental iron .	None
The infant was started on Ampicillin and Gentamycin at the time of admission for sepsis risk factor .	None
She had a head ultrasound on 2013-05-02 , that was completely within normal limits .	None
The infant is being discharged home with her parents .	None
1) Synagis RSV prophylaxis should be considered from October through April for infants who meet any of the following three criteria :	None
3. Sepsis , ruled out .	None
55 yo m w/ h/o problem s/p cystectomy w/ treatment p/w brbpr to osh .	TrAP
Anemia - baseline mid 30 s.	None
From Sao Tome originally .	None
2015-12-03 10:27 PM GLUCOSE - 88 UREA N - 12 CREAT - 1.0 SODIUM - 138 POTASSIUM - 3.3 CHLORIDE - 107 TOTAL CO2 - 25 ANION GAP - 9	None
2015-12-03 10:27 PM estGFR - Using this	None
2015-12-03 10:27 PM CALCIUM - 8.7 PHOSPHATE - 2.4 * MAGNESIUM - 1.5 *	None
Stable Hct of 31 .	None
A CT scan of your abdomen showed a right pelvic mass , most likely a hematoma , which had been described previously in 2015-03-28 .	None
he underwent test on 2016-04-05 which revealed a left ventricular ejection fraction of 50% , no mitral regurgitation , problem or hypokinesis .	TeRP
he underwent test on 2016-04-05 which revealed a left ventricular ejection fraction of 50% , no mitral regurgitation , insufficiency or problem .	TeRP
This is a 67 - year-old male with a history of high cholesterol who was in his usual state of health until 2016-04-03 .	None
Left main coronary artery was narrowed 50-60% , left anterior descending coronary artery 70% proximally , right coronary artery dominant diseased up to 90% proximally in the midportion , 70% distally .	None
3. Lopressor 25 mg p.o. b.i.d.	None
Neck : Supple with full range of motion , no lymphadenopathy nor thyromegaly .	None
Abdomen : Positive bowel sounds , soft , nontender , nondistended , no masses , no hepatosplenomegaly .	None
The patient had pacing wires and chest tubes in place , both of which over the course of his stay were removed successfully .	None
He was seen by physical therapy and cleared .	None
1. Lasix 20 mg p.o. q. 12 .	None
neurology was consulted due to the concern for problem1 in the setting of problem2 .	PIP
pregnancy was also complicated by maternal history of problem for which mother received treatment .	TrAP
the baby demonstrated problem with test obtained on day of life three which was 6.7 with a direct of 0.2 .	TeRP
he had a left pupil that was in problem1 with problem2 consistent with a coloboma .	PIP
Serologies include blood type O negative , antibody negative , RPR nonreactive .	None
There were no sepsis risk factors .	None
The Neonatal Intensive Care Unit was notified and the baby was transferred to the Newborn Intensive Care Unit for further evaluation .	None
Mucous membranes were moist and pink .	None
2 plus femoral pulses were noted .	None
HOSPITAL COURSE BY SYSTEMS :	None
This was minimized with limitation of volume at each feed with frequent feeding .	None
Mother 's blood type is O negative .	None
in the past , he has been problem and has seen treatment at greenfield community college community health .	TrAP
we will monitor for signs of problem according to test .	TeCP
problem1 on 02-07 is likely secondary to problem2 .	PIP
we will test for signs of problem according to the ciwa scale .	TeCP
problem in emergency room requiring 4 leather restraints , received 5 mg of treatment , 2 mg of ativan .	TrAP
Mr. Pohl is a 53 - year-old male with history of alcohol use and hypertension .	None
The patient told other staff that he had a few cocktails and drinking a few more glasses of wine when he ran into some friends at a bar .	None
EMS was called and the patient was taken to the emergency room .	None
He became hypotensive in the emergency room with a systolic blood pressure in the 80 's and had decreased respiratory rate .	None
The patient was then admitted to the medical Intensive Care Unit for observation of his blood pressure and then transferred to our service on medicine when the blood pressures remained stable overnight .	None
He is also concerned about the threat of war and is ready to " move to Madagascar ".	None
In the past , he has been very depressed and has seen a counselor at Greenfield Community College Community Health .	None
He came out here for college at BU and works as a computer programmer .	None
He uses condoms consistently .	None
3. Hydrochlorothiazide question of dosage .	None
3. Folic acid 1 mg q. d.	None
Vitals on admission : Please refer to addendum .	None
He states that mood is depressed .	None
Cranial nerves II-XII are grossly intact , 5/5 strength in all extremities , sensation is intact in all extremities .	None
Head , ears , eyes , nose and throat : Atraumatic and normocephalic .	None
at the time of transfer , he was initially admitted to the cmi service after undergoing cardiac catheterization which revealed problem that was angioplastied without treatment , and a total occlusion of the rca with collaterals .	TrAP
his stools were noted to be guaiac positive at the outside hospital and there was still concern for possible gi bleed given continued problem1 during this admission and problem2 from 39 to 33 .	PIP
he had a history of problem for which he is on baseline 2 liters of treatment by nasal cannula at home and albuterol and atrovent mdi s p.r.n. at home .	TrAP
at the time of transfer , he was initially admitted to the cmi service after undergoing test which revealed a long lad lesion that was angioplastied without stent placement , and problem with collaterals .	TeRP
problem1 , status post non-st elevation myocardial infarction with problem2 , now status post angioplasty .	PIP
this is an 82 - year-old male with a history of prior tobacco use , hypertension , chronic renal insufficiency , copd , gastritis , and tia who initially presented to braintree with a non-st elevation mi and guaiac positive stools , transferred to st. margaret's center for women & infants for cardiac catheterization with ptca to mid lad lesion complicated by problem and bradycardia requiring atropine , iv fluids and treatment possibly secondary to vagal reaction , subsequently transferred to ccu for close monitoring , hemodynamically stable at the time of admission to the ccu .	TrAP
as summarized above , the patient had a non-st elevation mi with evidence of problem for which he underwent angioplasty without treatment .	TrAP
test revealed a totally occluded rca with collaterals , problem extending distally which was angioplastied but no stent was placed .	TeRP
this is an 82 - year-old male with a history of prior tobacco use , hypertension , chronic renal insufficiency , copd , gastritis , and tia who initially presented to braintree with a non-st elevation mi and guaiac positive stools , transferred to st. margaret's center for women & infants for cardiac catheterization with ptca to mid lad lesion complicated by problem and bradycardia requiring treatment , iv fluids and transient dopamine possibly secondary to vagal reaction , subsequently transferred to ccu for close monitoring , hemodynamically stable at the time of admission to the ccu .	TrAP
his stools were noted to be problem1 at the outside hospital and there was still concern for possible gi bleed given continued problem1 stools during this admission and problem2 from 39 to 33 .	PIP
he subsequently became hypotensive and problem in the catheterization laboratory which responded to iv fluids , treatment , atropine , and he was then transferred to the ccu for further monitoring .	TrIP
problem with 2 liters dependence of treatment .	TrAP
After approximately one hour , he presented to the Bristol County Tuberculosis Hospital Dana-Farber Cancer Institute Campus where he ruled in for a non-ST elevation MI with a CK of 438 with a peak CK MB of 19.8 and troponin that peaked at 10.2 .	None
He denied any history of similar symptoms in the past and has had no prior history of angina or myocardial infarction .	None
There were no stents deployed at all throughout the catheterization .	None
He uses a cane p.r.n. for walking .	None
He denied any falls at home .	None
His only family member is a niece in Missouri .	None
He has a remote tobacco history and reports occasional alcohol use .	None
2. Metoprolol 50 mg b.i.d.	None
His lungs were clear to auscultation bilaterally Anteriorly and laterally .	None
On admission , the CBC revealed a white count of 7.4 , hematocrit 39.7 , and platelets of 217,000 .	None
The right heart catheterization revealed pulmonary capillary wedge pressure of 4 , cardiac output of 8 , and cardiac index of 3.8 , he had an RA pressure of 10 , RV pressure of 43/4 , PA pressure of 37/10 .	None
the hypotension was likely due to problem1 caused by problem2 / loose stools in addition to decreased po intake secondary to her gerd and thrush .	PIP
she will need outpatient follow up for problem with test vs egd +/- h.pylori serologies .	TeCP
3. problem1 : the patient has been having problem2 at night and was guiac pos x 2 .	PIP
there is no evidence of problem on test .	TeRP
however , she has no vomiting and problem with treatment .	TrCP
Her Hct dropped from Hct 38.9 before fluids to 35.5 s/p 1.5L NS and was thought to be dilutional .	None
She tolerated these meds with SBP s in the high 90 s to 100 s and was therefore discharged on this regimen .	None
She will need outpatient follow up for her guiac pos stools with endoscopy vs EGD +/- H.pylori serologies .	None
A copy of this dc summary will be faxed to her PCP to ensure proper follow up .	None
2. Pantoprazole 40 mg Tablet , Delayed Release ( E.C. ) Sig : One ( 1 ) Tablet , Delayed Release ( E.C. ) PO twice a day .	None
11. Senna 8.6 mg Tablet Sig : One ( 1 ) Tablet PO BID ( 2 times a day ) as needed .	None
If you experience CP , SOB , dizzyness , or any other symptoms that concern you please call your PCP or return to the ER .	None
the patient had an echocardiogram on day two of admission , which revealed a mildly dilated left atrium , mild symmetric lvh , normal lv cavity size , mild region lv systolic dysfunction , problem1 including problem2 , a normal right ventricular chamber size and free wall motion , a moderately dilated aortic root , a mildly dilated ascending aorta , normal aortic valve leaflet , normal mitral valve leaflet and no pericardial effusions .	PIP
there were no lifts or problem on test .	TeRP
the patient had test on day two of admission , which revealed a mildly dilated left atrium , mild symmetric lvh , normal lv cavity size , problem , arresting regional wall motion abnormality including focal apical hypokinesis , a normal right ventricular chamber size and free wall motion , a moderately dilated aortic root , a mildly dilated ascending aorta , normal aortic valve leaflet , normal mitral valve leaflet and no pericardial effusions .	TeRP
hypertension was managed with beta blocker and ace inhibitor and treatment was continued post problem for 18 hours .	TrAP
aspirin 325 mg q.d. , plavix 75 mg q.d. , lipitor 20 mg q.d. , treatment 0.3 mg sublingually p.r.n. problem or pressure or shortness of breath , lisinopril hydrochlorothiazide 20 / 12.5 mg q.d. , atenolol 25 mg q.d.	TrAP
aspirin 325 mg q.d. , plavix 75 mg q.d. , lipitor 20 mg q.d. , treatment 0.3 mg sublingually p.r.n. chest pain or problem or shortness of breath , lisinopril hydrochlorothiazide 20 / 12.5 mg q.d. , atenolol 25 mg q.d.	TrAP
test revealed left main , left circumflex and rca normal and problem .	TeRP
this morning while landscaping the patient had problem1 with problem2 and diaphoresis .	PIP
problem was managed with beta blocker and treatment and integrilin was continued post mi for 18 hours .	TrAP
Antihypertensive medications that the patient could not identify .	None
PHYSICAL EXAMINATION ON ADMISSION :	None
Blood pressure 156/67 , pulse 80 and respiratory rate 14 .	None
The patient did not have any carotid bruits , abdominal bruits or femoral bruits .	None
Significant for what was stated in the HPI .	None
Captopril 6.2 3 x a day and titrated up .	None
A lipid panel was checked and found to be within normal limits , although it was noted this was in the post MI setting and the lipid panel could be falsely low .	None
The patient had an echocardiogram on day two of admission , which revealed a mildly dilated left atrium , mild symmetric LVH , normal LV cavity size , mild region LV systolic dysfunction , arresting regional wall motion abnormality including focal apical hypokinesis , a normal right ventricular chamber size and free wall motion , a moderately dilated aortic root , a mildly dilated ascending aorta , normal aortic valve leaflet , normal mitral valve leaflet and no pericardial effusions .	None
The patient was normal volume and displayed no evidence CHF signs or symptoms .	None